################################E####
###....#.....#..C...###...#...#...#.#
#...##...###...####..C..#..##.#.##..#
#.#########.###....##.####.##.#.#..##
#.............##.######..#......#...#
#####.#####.#..C..C......##########.#
#S..........###.#.#.##.C............#
#####################################